64 64 1
16 1 0 16 1 0 16 1 0 16 1 0 16 1 1 16 1 1 16 1 1 16 1 1 16 1 1 16 1 1 16 1 1 16 1 1 16 1 0 16 1 0 16 1 0 16 1 0 16 1 0 16 1 0 16 1 0 16 1 0 16 1 0 16 1 0 16 1 0 16 1 0 16 1 0 16 1 0 16 1 0 16 1 0 16 1 0 16 1 0 16 1 0 16 1 0 16 1 0 16 1 0 16 1 0 16 1 0 16 1 0 16 1 0 16 1 0 16 1 0 16 1 0 16 1 0 16 1 0 16 1 0 16 1 0 16 1 0 16 1 0 16 1 0 16 1 0 16 1 0 16 1 0 16 1 0 16 1 0 16 1 0 16 1 0 16 1 0 16 1 0 16 1 0 16 1 0 16 1 0 16 1 0 16 1 0 16 1 0 16 1 0
16 1 0 16 1 0 16 1 0 16 1 1 16 1 1 18 1 0 26 1 0 26 1 0 26 1 0 26 1 0 19 1 0 16 1 1 16 1 1 16 1 0 16 1 0 16 1 0 16 1 0 16 1 0 16 1 0 16 1 0 16 1 0 16 1 0 16 1 0 16 1 0 16 1 0 16 1 0 16 1 0 16 1 0 16 1 0 16 1 0 16 1 0 16 1 0 16 1 0 16 1 0 16 1 1 16 1 1 16 1 1 16 1 1 16 1 1 16 1 1 16 1 1 16 1 1 16 1 1 16 1 1 16 1 1 16 1 1 16 1 0 16 1 0 16 1 0 16 1 0 16 1 0 16 1 0 16 1 0 16 1 0 16 1 0 16 1 1 16 1 1 16 1 1 16 1 1 16 1 1 16 1 1 16 1 1 16 1 0 16 1 0
16 1 0 16 1 0 16 1 1 16 1 1 18 1 0 27 1 0 1 1 0 1 1 0 1 1 0 1 1 0 25 1 0 19 1 0 16 1 1 16 1 0 16 1 0 16 1 0 16 1 0 16 1 0 16 1 0 16 1 0 16 1 0 16 1 0 16 1 0 16 1 0 16 1 0 16 1 1 16 1 1 16 1 1 16 1 1 16 1 1 16 1 1 16 1 1 16 1 1 16 1 1 16 1 1 18 1 0 26 1 0 26 1 0 26 1 0 26 1 0 26 1 0 26 1 0 26 1 0 26 1 0 19 1 0 16 1 1 16 1 1 16 1 1 16 1 1 16 1 0 16 1 0 16 1 0 16 1 1 16 1 1 16 1 1 16 1 1 18 1 0 26 1 0 26 1 0 26 1 0 19 1 0 16 1 1 16 1 1 16 1 0
16 1 0 16 1 0 16 1 1 18 1 0 27 1 0 1 1 0 1 1 0 1 9 0 1 1 0 1 1 0 1 1 0 15 1 0 16 1 1 16 1 0 16 1 0 16 1 0 16 1 0 16 1 0 16 1 0 16 1 0 16 1 0 16 1 0 16 1 0 16 1 0 16 1 1 16 1 1 18 1 0 26 1 0 26 1 0 26 1 0 26 1 0 26 1 0 26 1 0 26 1 0 26 1 0 27 1 0 1 1 0 1 1 0 1 1 0 1 1 0 1 1 0 1 1 0 1 1 0 1 1 0 25 1 0 26 1 0 26 1 0 19 1 0 16 1 1 16 1 1 16 1 1 16 1 1 16 1 1 18 1 0 26 1 0 26 1 0 27 1 0 1 1 0 1 1 0 1 1 0 25 1 0 19 1 0 16 1 1 16 1 1
16 1 0 16 1 1 16 1 1 17 1 0 1 1 0 1 1 0 1 1 0 1 1 0 1 1 0 1 1 0 1 1 0 15 1 0 16 1 1 16 1 1 16 1 0 16 1 0 16 1 0 16 1 0 16 1 0 16 1 1 16 1 1 16 1 1 16 1 1 16 1 1 16 1 1 18 1 0 27 1 0 1 1 0 1 1 0 1 1 0 1 1 0 1 1 0 1 1 0 1 1 0 1 1 0 1 1 0 2 1 0 4 1 0 1 1 0 1 1 0 1 1 0 1 1 0 1 1 0 1 1 0 1 1 0 1 1 0 1 1 0 25 1 0 26 1 0 26 1 0 26 1 0 26 1 0 26 1 0 27 1 0 1 1 0 1 1 0 1 1 0 1 1 0 1 1 0 1 1 0 1 1 0 25 1 0 19 1 0 16 1 1
16 1 0 16 1 1 18 1 0 27 1 0 1 1 0 1 1 0 1 1 0 1 1 0 1 1 0 1 1 0 1 9 0 25 1 0 19 1 0 16 1 1 16 1 1 16 1 1 16 1 1 16 1 1 16 1 1 16 1 1 18 1 0 26 1 0 26 1 0 26 1 0 26 1 0 27 1 0 1 1 0 1 1 0 1 1 0 1 1 0 1 1 0 1 1 0 1 1 0 2 1 0 3 1 0 3 1 0 21 1 0 20 1 0 4 1 0 1 1 0 1 1 0 1 1 0 1 1 0 1 1 0 1 1 0 1 1 0 1 1 0 1 1 0 1 1 0 1 1 0 1 1 0 1 1 0 1 1 0 1 1 0 1 1 0 1 1 0 1 1 0 1 1 0 1 1 0 1 1 0 1 1 0 1 1 0 15 1 0 16 1 1
16 1 0 16 1 1 17 1 0 1 1 0 1 1 0 1 9 0 1 1 0 1 1 0 1 1 0 1 1 0 1 1 0 1 1 0 25 1 0 26 1 0 26 1 0 19 1 0 16 1 1 18 1 0 26 1 0 26 1 0 27 1 0 1 1 0 1 1 0 1 1 0 1 1 0 1 1 0 1 1 0 1 1 0 1 1 0 1 1 0 1 1 0 1 1 0 2 1 0 21 1 0 13 1 0 13 1 0 13 1 0 13 1 0 14 1 0 1 1 0 1 1 0 1 1 0 1 1 0 1 1 0 1 9 0 1 1 0 1 1 0 1 1 0 1 1 0 1 1 0 1 1 0 1 1 0 1 1 0 1 1 0 1 1 0 1 1 0 1 1 0 1 1 0 1 1 0 1 1 0 1 1 0 1 1 0 15 1 0 16 1 1
16 1 0 16 1 1 17 1 0 1 1 0 1 1 0 1 1 0 1 1 0 1 1 0 1 1 0 1 1 0 1 1 0 1 1 0 1 1 0 1 1 0 1 1 0 25 1 0 26 1 0 27 1 0 1 1 0 1 1 0 1 1 0 1 1 0 1 1 0 1 1 0 1 1 0 1 1 0 1 1 0 1 1 0 1 1 0 1 1 0 1 1 0 1 1 0 12 1 0 13 1 0 13 1 0 13 1 0 13 1 0 13 1 0 14 1 0 1 1 0 1 1 0 1 1 0 1 1 0 1 1 0 1 1 0 1 1 0 1 1 0 1 1 0 1 1 0 1 1 0 1 1 0 1 1 0 1 1 0 1 1 0 1 1 0 1 1 0 1 1 0 1 1 0 1 1 0 1 1 0 1 1 0 5 1 0 29 1 0 16 1 1
16 1 0 16 1 1 28 1 0 7 1 0 1 1 0 1 1 0 1 1 0 1 1 0 1 1 0 1 1 0 1 1 0 1 1 0 1 1 0 1 1 0 1 1 0 1 1 0 1 1 0 1 1 0 1 1 0 1 1 0 1 1 0 1 1 0 1 1 0 1 1 0 1 1 0 1 1 0 1 1 0 1 1 0 1 9 0 1 1 0 1 1 0 1 1 0 12 1 0 13 1 0 13 1 0 13 1 0 10 1 0 23 1 0 24 1 0 1 1 0 1 1 0 1 1 0 1 1 0 1 1 0 1 1 0 1 1 0 1 1 0 1 1 0 1 1 0 1 1 0 5 1 0 6 1 0 7 1 0 1 1 0 1 1 0 1 1 0 1 1 0 1 1 0 1 1 0 1 1 0 5 1 0 29 1 0 16 1 1 16 1 1
16 1 0 16 1 1 16 1 1 28 1 0 6 1 0 6 1 0 6 1 0 7 1 0 1 1 0 1 1 0 1 1 0 1 1 0 1 9 0 1 1 0 1 1 0 1 1 0 1 1 0 1 1 0 1 1 0 1 1 0 1 1 0 1 1 0 1 1 0 1 1 0 1 1 0 1 1 0 1 1 0 1 1 0 1 1 0 1 1 0 1 1 0 1 1 0 22 1 0 23 1 0 23 1 0 23 1 0 24 1 0 1 1 0 1 1 0 1 1 0 1 1 0 1 1 0 1 1 0 1 9 0 1 1 0 1 1 0 1 1 0 1 1 0 1 1 0 5 1 0 29 1 0 16 1 1 28 1 0 6 1 0 7 1 0 1 1 0 1 1 0 1 1 0 1 1 0 1 1 0 15 1 0 16 1 1 16 1 1 16 1 0
16 1 0 16 1 0 16 1 1 16 1 1 16 1 1 16 1 1 16 1 1 28 1 0 7 1 0 1 1 0 1 1 0 1 1 0 1 1 0 1 1 0 1 1 0 1 1 0 1 1 0 1 1 0 1 1 0 1 1 0 1 1 0 1 1 0 1 1 0 1 1 0 1 1 0 1 1 0 1 1 0 1 1 0 1 1 0 1 1 0 1 1 0 1 1 0 1 1 0 1 1 0 1 1 0 1 1 0 1 1 0 1 1 0 1 1 0 1 1 0 1 1 0 1 1 0 1 1 0 1 1 0 1 1 0 1 1 0 1 1 0 1 1 0 1 1 0 15 1 0 16 1 1 16 1 1 16 1 1 16 1 1 28 1 0 7 1 0 1 1 0 1 1 0 1 1 0 1 1 0 15 1 0 16 1 1 16 1 0 16 1 0
16 1 0 16 1 0 16 1 0 16 1 0 16 1 0 16 1 0 16 1 1 16 1 1 28 1 0 7 1 0 1 1 0 1 1 0 1 1 0 2 1 0 3 1 0 3 1 0 4 1 0 1 1 0 1 1 0 1 1 0 1 1 0 1 1 0 5 1 0 6 1 0 7 1 0 1 1 0 1 1 0 1 1 0 1 1 0 1 1 0 1 1 0 1 1 0 1 1 0 1 1 0 1 1 0 1 1 0 1 1 0 1 1 0 1 1 0 1 9 0 1 1 0 1 1 0 1 1 0 1 1 0 1 1 0 1 1 0 1 1 0 1 1 0 1 1 0 25 1 0 26 1 0 19 1 0 16 1 1 18 1 0 26 1 0 27 1 0 1 1 0 1 1 0 1 1 0 1 1 0 15 1 0 16 1 1 16 1 0 16 1 0
16 1 0 16 1 0 16 1 0 16 1 0 16 1 0 16 1 0 16 1 0 16 1 1 18 1 0 27 1 0 1 1 0 2 1 0 3 1 0 21 1 0 13 1 0 13 1 0 14 1 0 1 1 0 1 1 0 1 1 0 1 1 0 5 1 0 29 1 0 16 1 1 28 1 0 7 1 0 1 1 0 1 1 0 1 1 0 1 1 0 1 1 0 1 9 0 1 1 0 1 1 0 1 1 0 1 1 0 1 1 0 1 1 0 1 1 0 1 1 0 1 1 0 1 1 0 1 1 0 1 1 0 1 1 0 1 1 0 1 1 0 1 1 0 1 1 0 1 1 0 1 1 0 25 1 0 26 1 0 27 1 0 1 1 0 1 1 0 1 9 0 1 1 0 1 1 0 1 1 0 15 1 0 16 1 1 16 1 0 16 1 0
16 1 0 16 1 0 16 1 0 16 1 0 16 1 0 16 1 1 16 1 1 16 1 1 17 1 0 1 1 0 1 1 0 12 1 0 13 1 0 13 1 0 13 1 0 13 1 0 14 1 0 1 1 0 1 1 0 1 1 0 1 1 0 25 1 0 19 1 0 18 1 0 26 1 0 27 1 0 1 1 0 1 1 0 1 1 0 1 1 0 1 1 0 1 1 0 1 1 0 1 1 0 1 1 0 1 1 0 1 1 0 1 1 0 1 1 0 1 1 0 1 1 0 1 1 0 1 1 0 1 1 0 1 1 0 1 1 0 1 1 0 1 1 0 1 1 0 1 1 0 1 1 0 1 1 0 1 1 0 1 1 0 1 1 0 1 1 0 1 1 0 1 1 0 1 1 0 1 1 0 15 1 0 16 1 1 16 1 1 16 1 0
16 1 0 16 1 0 16 1 0 16 1 0 16 1 1 16 1 1 18 1 0 26 1 0 27 1 0 1 1 0 1 1 0 12 1 0 13 1 0 13 1 0 13 1 0 10 1 0 24 1 0 1 1 0 1 1 0 1 1 0 1 1 0 1 1 0 25 1 0 27 1 0 1 1 0 1 1 0 1 1 0 1 1 0 1 1 0 1 1 0 1 1 0 1 1 0 1 1 0 1 1 0 1 1 0 1 1 0 5 1 0 6 1 0 6 1 0 7 1 0 1 1 0 1 1 0 1 1 0 1 1 0 1 1 0 1 1 0 1 1 0 1 1 0 1 1 0 1 1 0 1 1 0 1 1 0 1 1 0 1 1 0 1 1 0 1 1 0 1 1 0 1 1 0 1 1 0 1 1 0 25 1 0 19 1 0 16 1 1 16 1 0
16 1 0 16 1 0 16 1 0 16 1 0 16 1 1 18 1 0 27 1 0 1 1 0 1 1 0 1 1 0 2 1 0 21 1 0 13 1 0 13 1 0 10 1 0 24 1 0 1 1 0 1 1 0 1 1 0 1 1 0 1 1 0 1 1 0 1 1 0 1 1 0 1 1 0 1 1 0 1 1 0 1 9 0 1 1 0 1 1 0 1 1 0 1 1 0 1 1 0 5 1 0 6 1 0 6 1 0 29 1 0 16 1 1 16 1 1 28 1 0 6 1 0 6 1 0 6 1 0 7 1 0 1 1 0 1 1 0 1 1 0 1 9 0 1 1 0 1 1 0 1 1 0 1 1 0 1 1 0 1 1 0 1 1 0 1 1 0 1 1 0 1 1 0 1 1 0 1 1 0 1 1 0 15 1 0 16 1 1 16 1 0
16 1 0 16 1 0 16 1 0 16 1 0 16 1 1 17 1 0 1 1 0 1 1 0 1 1 0 1 1 0 12 1 0 13 1 0 13 1 0 13 1 0 14 1 0 1 1 0 1 1 0 1 1 0 1 1 0 1 1 0 1 1 0 1 1 0 1 1 0 1 1 0 1 1 0 1 1 0 1 1 0 1 1 0 1 1 0 1 1 0 1 1 0 1 1 0 1 1 0 15 1 0 16 1 1 16 1 1 16 1 1 16 1 1 16 1 1 16 1 1 16 1 1 16 1 1 16 1 1 28 1 0 6 1 0 6 1 0 7 1 0 1 1 0 1 1 0 1 1 0 1 1 0 1 1 0 1 1 0 1 1 0 1 1 0 1 9 0 1 1 0 1 1 0 1 1 0 1 1 0 1 1 0 15 1 0 16 1 1 16 1 0
16 1 0 16 1 0 16 1 0 16 1 0 16 1 1 17 1 0 1 1 0 1 1 0 1 1 0 1 1 0 22 1 0 23 1 0 23 1 0 23 1 0 24 1 0 1 1 0 1 1 0 1 1 0 1 1 0 1 1 0 1 1 0 1 1 0 1 1 0 1 1 0 1 1 0 1 1 0 1 1 0 1 1 0 1 1 0 1 1 0 1 1 0 1 1 0 5 1 0 29 1 0 16 1 1 16 1 0 16 1 0 16 1 0 16 1 0 16 1 0 16 1 0 16 1 0 16 1 1 16 1 1 16 1 1 16 1 1 28 1 0 6 1 0 6 1 0 7 1 0 1 1 0 1 1 0 1 1 0 1 1 0 1 1 0 1 1 0 1 1 0 1 1 0 1 1 0 1 1 0 5 1 0 29 1 0 16 1 1 16 1 0
16 1 0 16 1 0 16 1 0 16 1 0 16 1 1 17 1 0 1 1 0 1 1 0 1 1 0 1 1 0 1 1 0 1 1 0 1 1 0 1 1 0 1 1 0 1 1 0 1 1 0 1 1 0 1 1 0 1 1 0 1 1 0 1 1 0 1 1 0 1 1 0 1 1 0 1 1 0 1 1 0 1 1 0 1 1 0 1 1 0 1 9 0 1 1 0 15 1 0 16 1 1 16 1 1 16 1 0 16 1 0 16 1 0 16 1 0 16 1 0 16 1 0 16 1 0 16 1 0 16 1 0 16 1 0 16 1 1 16 1 1 16 1 1 16 1 1 28 1 0 6 1 0 6 1 0 7 1 0 1 1 0 1 1 0 1 1 0 1 1 0 1 1 0 1 1 0 1 1 0 15 1 0 16 1 1 16 1 1 16 1 0
16 1 0 16 1 0 16 1 0 16 1 0 16 1 1 17 1 0 1 1 0 1 1 0 1 1 0 1 1 0 1 9 0 1 1 0 1 1 0 1 1 0 1 1 0 1 1 0 1 1 0 1 1 0 1 1 0 1 1 0 1 1 0 1 9 0 1 1 0 1 1 0 1 1 0 1 1 0 1 1 0 1 1 0 1 1 0 1 1 0 1 1 0 1 1 0 25 1 0 19 1 0 16 1 1 16 1 0 16 1 0 16 1 0 16 1 0 16 1 0 16 1 0 16 1 0 16 1 0 16 1 0 16 1 0 16 1 0 16 1 0 16 1 0 16 1 1 16 1 1 16 1 1 16 1 1 28 1 0 6 1 0 7 1 0 1 1 0 1 1 0 1 1 0 1 1 0 1 1 0 15 1 0 16 1 1 16 1 0 16 1 0
16 1 0 16 1 0 16 1 0 16 1 1 16 1 1 17 1 0 1 1 0 1 1 0 1 1 0 1 1 0 1 1 0 1 1 0 1 1 0 1 1 0 1 1 0 1 1 0 1 1 0 1 1 0 1 1 0 1 1 0 1 1 0 1 1 0 1 1 0 1 1 0 1 1 0 1 1 0 1 1 0 1 1 0 1 1 0 1 1 0 1 1 0 1 1 0 1 1 0 15 1 0 16 1 1 16 1 1 16 1 0 16 1 0 16 1 0 16 1 0 16 1 0 16 1 0 16 1 0 16 1 0 16 1 0 16 1 0 16 1 0 16 1 0 16 1 0 16 1 0 16 1 0 16 1 1 16 1 1 16 1 1 28 1 0 6 1 0 6 1 0 6 1 0 6 1 0 6 1 0 29 1 0 16 1 1 16 1 0 16 1 0
16 1 0 16 1 0 16 1 1 16 1 1 18 1 0 27 1 0 1 1 0 1 1 0 1 1 0 1 1 0 1 1 0 1 1 0 1 1 0 5 1 0 6 1 0 6 1 0 6 1 0 6 1 0 6 1 0 7 1 0 1 1 0 1 1 0 1 1 0 1 1 0 1 1 0 1 1 0 1 1 0 1 1 0 1 1 0 1 1 0 1 1 0 1 1 0 1 1 0 25 1 0 19 1 0 16 1 1 16 1 0 16 1 0 16 1 0 16 1 0 16 1 0 16 1 0 16 1 0 16 1 0 16 1 0 16 1 0 16 1 0 16 1 0 16 1 0 16 1 0 16 1 0 16 1 1 16 1 1 16 1 1 16 1 1 16 1 1 16 1 1 16 1 1 16 1 1 16 1 1 16 1 1 16 1 1 16 1 0 16 1 0
16 1 0 16 1 1 16 1 1 18 1 0 27 1 0 1 1 0 1 1 0 1 1 0 1 1 0 1 1 0 1 1 0 1 1 0 5 1 0 29 1 0 16 1 1 16 1 1 16 1 1 16 1 1 16 1 1 28 1 0 7 1 0 1 1 0 1 1 0 1 1 0 1 1 0 1 1 0 1 1 0 1 1 0 1 1 0 1 1 0 1 1 0 1 1 0 1 1 0 1 1 0 15 1 0 16 1 1 16 1 1 16 1 1 16 1 1 16 1 0 16 1 0 16 1 0 16 1 0 16 1 0 16 1 0 16 1 0 16 1 1 16 1 1 16 1 1 16 1 1 16 1 1 16 1 1 18 1 0 26 1 0 26 1 0 26 1 0 26 1 0 26 1 0 26 1 0 19 1 0 16 1 1 16 1 0 16 1 0 16 1 0
16 1 0 16 1 1 18 1 0 27 1 0 1 1 0 1 1 0 1 1 0 1 1 0 1 1 0 1 1 0 1 1 0 1 1 0 15 1 0 16 1 1 16 1 1 16 1 0 16 1 0 16 1 0 16 1 1 16 1 1 17 1 0 1 1 0 1 1 0 1 1 0 1 1 0 1 9 0 1 1 0 1 1 0 1 1 0 1 1 0 1 1 0 1 1 0 1 1 0 1 1 0 25 1 0 26 1 0 26 1 0 19 1 0 16 1 1 16 1 1 16 1 1 16 1 1 16 1 1 16 1 1 16 1 1 16 1 1 16 1 1 18 1 0 26 1 0 26 1 0 26 1 0 26 1 0 27 1 0 1 1 0 1 1 0 1 1 0 1 1 0 1 1 0 1 1 0 15 1 0 16 1 1 16 1 0 16 1 0 16 1 0
16 1 0 16 1 1 17 1 0 1 1 0 1 1 0 1 1 0 1 1 0 1 1 0 1 1 0 1 1 0 1 1 0 1 1 0 25 1 0 19 1 0 16 1 1 16 1 0 16 1 0 16 1 0 16 1 1 18 1 0 27 1 0 1 1 0 1 1 0 1 1 0 1 1 0 1 1 0 1 1 0 1 1 0 1 1 0 1 1 0 1 1 0 1 1 0 1 1 0 1 1 0 1 1 0 1 1 0 1 1 0 25 1 0 26 1 0 26 1 0 26 1 0 26 1 0 26 1 0 26 1 0 26 1 0 26 1 0 26 1 0 27 1 0 1 1 0 1 1 0 1 1 0 1 1 0 1 1 0 1 1 0 1 1 0 1 1 0 1 1 0 1 1 0 1 1 0 15 1 0 16 1 1 16 1 0 16 1 0 16 1 0
16 1 0 16 1 1 28 1 0 7 1 0 1 1 0 1 1 0 1 1 0 1 9 0 1 1 0 1 1 0 1 1 0 1 1 0 1 1 0 15 1 0 16 1 1 16 1 1 16 1 0 16 1 1 16 1 1 17 1 0 1 1 0 1 1 0 1 1 0 1 1 0 1 1 0 1 1 0 1 1 0 1 1 0 1 1 0 1 1 0 1 1 0 1 1 0 1 1 0 1 1 0 1 1 0 1 1 0 1 1 0 1 1 0 1 1 0 1 1 0 1 1 0 1 1 0 1 1 0 1 1 0 1 1 0 1 1 0 1 1 0 1 1 0 1 1 0 1 1 0 1 1 0 1 1 0 1 1 0 1 1 0 1 1 0 1 1 0 1 1 0 1 1 0 1 1 0 15 1 0 16 1 1 16 1 0 16 1 0 16 1 0
16 1 0 16 1 1 16 1 1 17 1 0 1 1 0 1 1 0 1 1 0 1 1 0 1 1 0 1 1 0 1 1 0 1 1 0 1 1 0 25 1 0 19 1 0 16 1 1 16 1 1 16 1 1 18 1 0 27 1 0 1 1 0 1 1 0 1 1 0 1 1 0 1 1 0 1 1 0 1 1 0 1 1 0 1 1 0 1 1 0 1 1 0 1 1 0 1 1 0 1 1 0 1 1 0 1 1 0 1 1 0 1 1 0 1 1 0 1 1 0 1 1 0 1 1 0 1 1 0 1 1 0 1 1 0 1 1 0 1 1 0 1 1 0 1 1 0 1 1 0 1 1 0 1 1 0 1 1 0 1 1 0 1 1 0 1 1 0 1 9 0 1 1 0 1 1 0 15 1 0 16 1 1 16 1 0 16 1 0 16 1 0
16 1 0 16 1 0 16 1 1 17 1 0 1 1 0 1 1 0 1 1 0 1 1 0 1 1 0 1 1 0 1 1 0 1 1 0 1 1 0 1 1 0 25 1 0 26 1 0 26 1 0 26 1 0 27 1 0 1 1 0 1 1 0 1 1 0 1 1 0 1 1 0 1 1 0 1 1 0 1 1 0 1 1 0 1 1 0 1 1 0 1 1 0 1 1 0 1 1 0 1 1 0 1 1 0 1 1 0 1 1 0 1 1 0 1 1 0 1 1 0 1 1 0 1 1 0 1 1 0 1 9 0 1 1 0 1 1 0 1 1 0 1 1 0 1 1 0 1 1 0 2 1 0 3 1 0 4 1 0 1 1 0 1 1 0 1 1 0 1 1 0 1 1 0 1 1 0 15 1 0 16 1 1 16 1 0 16 1 0 16 1 0
16 1 0 16 1 0 16 1 1 17 1 0 1 1 0 1 1 0 1 1 0 1 1 0 1 1 0 1 1 0 1 1 0 1 1 0 1 1 0 1 1 0 1 1 0 1 1 0 1 1 0 1 1 0 1 1 0 1 1 0 1 1 0 1 1 0 1 1 0 1 1 0 2 1 0 3 1 0 3 1 0 3 1 0 4 1 0 2 1 0 3 1 0 4 1 0 1 1 0 1 1 0 1 1 0 1 1 0 1 1 0 1 1 0 1 1 0 1 1 0 1 1 0 1 1 0 1 1 0 1 1 0 1 1 0 2 1 0 3 1 0 3 1 0 3 1 0 3 1 0 21 1 0 13 1 0 20 1 0 4 1 0 1 1 0 1 1 0 1 1 0 1 1 0 1 1 0 15 1 0 16 1 1 16 1 0 16 1 0 16 1 0
16 1 0 16 1 0 16 1 1 17 1 0 1 1 0 1 1 0 1 1 0 1 1 0 1 1 0 1 1 0 1 1 0 1 1 0 1 1 0 1 1 0 1 1 0 1 1 0 1 1 0 1 1 0 1 1 0 1 1 0 1 1 0 1 1 0 1 1 0 2 1 0 21 1 0 13 1 0 13 1 0 13 1 0 20 1 0 21 1 0 13 1 0 14 1 0 1 1 0 1 1 0 1 1 0 1 1 0 1 1 0 1 1 0 1 1 0 1 1 0 1 1 0 1 1 0 1 1 0 2 1 0 3 1 0 21 1 0 13 1 0 13 1 0 13 1 0 13 1 0 13 1 0 13 1 0 13 1 0 14 1 0 1 1 0 1 1 0 1 1 0 1 1 0 1 1 0 15 1 0 16 1 1 16 1 0 16 1 0 16 1 0
16 1 0 16 1 0 16 1 1 17 1 0 1 1 0 1 1 0 1 1 0 1 1 0 1 1 0 1 1 0 1 1 0 1 1 0 1 1 0 1 1 0 1 1 0 1 1 0 1 1 0 1 1 0 1 1 0 1 1 0 1 1 0 1 1 0 1 1 0 12 1 0 13 1 0 13 1 0 13 1 0 13 1 0 13 1 0 13 1 0 10 1 0 24 1 0 1 1 0 1 1 0 1 1 0 1 1 0 1 9 0 1 1 0 1 1 0 1 1 0 1 1 0 1 1 0 1 1 0 12 1 0 13 1 0 13 1 0 13 1 0 13 1 0 13 1 0 13 1 0 13 1 0 13 1 0 10 1 0 24 1 0 1 1 0 1 1 0 1 1 0 1 1 0 5 1 0 29 1 0 16 1 1 16 1 0 16 1 0 16 1 0
16 1 0 16 1 0 16 1 1 17 1 0 1 1 0 1 1 0 1 1 0 1 1 0 1 1 0 1 1 0 1 1 0 1 1 0 1 1 0 1 1 0 1 1 0 1 9 0 1 1 0 1 1 0 1 1 0 1 1 0 1 1 0 1 1 0 2 1 0 21 1 0 13 1 0 13 1 0 13 1 0 13 1 0 13 1 0 13 1 0 14 1 0 1 1 0 1 1 0 1 9 0 1 1 0 1 1 0 1 1 0 1 1 0 1 1 0 1 1 0 1 1 0 1 1 0 1 1 0 12 1 0 13 1 0 13 1 0 13 1 0 13 1 0 10 1 0 23 1 0 23 1 0 23 1 0 24 1 0 1 1 0 1 1 0 1 1 0 1 1 0 1 1 0 15 1 0 16 1 1 16 1 1 16 1 0 16 1 0 16 1 0
16 1 0 16 1 0 16 1 1 17 1 0 1 1 0 1 1 0 1 1 0 1 1 0 1 1 0 1 1 0 1 1 0 1 1 0 1 1 0 1 1 0 1 1 0 1 1 0 1 1 0 1 1 0 1 1 0 1 1 0 1 1 0 1 1 0 12 1 0 13 1 0 13 1 0 13 1 0 13 1 0 13 1 0 13 1 0 10 1 0 24 1 0 1 1 0 1 1 0 1 1 0 1 1 0 1 1 0 1 1 0 1 1 0 1 1 0 1 1 0 1 1 0 1 1 0 1 1 0 22 1 0 23 1 0 23 1 0 23 1 0 23 1 0 24 1 0 1 1 0 1 1 0 1 1 0 1 1 0 1 1 0 1 1 0 1 1 0 1 1 0 1 1 0 15 1 0 16 1 1 16 1 0 16 1 0 16 1 0 16 1 0
16 1 0 16 1 0 16 1 1 17 1 0 1 1 0 1 1 0 1 1 0 1 1 0 1 1 0 1 1 0 1 1 0 1 1 0 1 1 0 1 1 0 1 1 0 1 1 0 1 1 0 1 1 0 1 1 0 1 1 0 1 1 0 1 1 0 12 1 0 13 1 0 13 1 0 13 1 0 10 1 0 23 1 0 23 1 0 24 1 0 1 1 0 1 1 0 1 1 0 1 1 0 1 1 0 1 9 0 1 1 0 1 1 0 1 1 0 1 1 0 1 1 0 1 1 0 1 1 0 1 1 0 1 1 0 1 1 0 1 1 0 1 1 0 1 1 0 1 1 0 1 1 0 1 1 0 1 1 0 1 1 0 1 1 0 1 1 0 1 1 0 5 1 0 29 1 0 16 1 1 16 1 0 16 1 0 16 1 0 16 1 0
16 1 0 16 1 1 16 1 1 17 1 0 1 1 0 1 1 0 1 1 0 1 1 0 1 1 0 5 1 0 6 1 0 7 1 0 1 1 0 1 1 0 1 1 0 1 1 0 1 1 0 1 1 0 1 1 0 1 1 0 1 1 0 1 1 0 22 1 0 11 1 0 13 1 0 13 1 0 14 1 0 1 1 0 1 1 0 1 1 0 1 1 0 1 1 0 1 1 0 1 1 0 1 1 0 1 1 0 1 1 0 1 1 0 1 1 0 1 1 0 1 1 0 1 1 0 1 1 0 1 1 0 1 1 0 1 1 0 1 1 0 1 1 0 1 1 0 1 1 0 1 1 0 1 1 0 1 9 0 1 1 0 1 1 0 1 1 0 1 1 0 15 1 0 16 1 1 16 1 1 16 1 0 16 1 0 16 1 0 16 1 0
16 1 0 16 1 1 18 1 0 27 1 0 1 1 0 1 1 0 1 1 0 1 1 0 5 1 0 29 1 0 16 1 1 28 1 0 7 1 0 1 1 0 1 1 0 1 1 0 1 1 0 1 1 0 1 1 0 1 1 0 1 1 0 1 1 0 1 1 0 22 1 0 23 1 0 23 1 0 24 1 0 1 1 0 1 1 0 1 1 0 1 1 0 1 1 0 1 1 0 1 1 0 1 1 0 1 1 0 1 1 0 1 1 0 1 1 0 1 1 0 1 1 0 1 1 0 1 1 0 1 1 0 1 1 0 1 1 0 1 1 0 1 1 0 1 1 0 1 1 0 1 1 0 1 1 0 1 1 0 1 1 0 1 1 0 1 1 0 1 1 0 15 1 0 16 1 1 16 1 0 16 1 0 16 1 0 16 1 0 16 1 0
16 1 0 16 1 1 17 1 0 1 1 0 1 1 0 1 1 0 1 1 0 1 1 0 25 1 0 19 1 0 16 1 1 18 1 0 27 1 0 1 1 0 1 1 0 1 1 0 1 1 0 1 1 0 1 1 0 1 1 0 1 1 0 1 1 0 1 1 0 1 1 0 1 1 0 1 1 0 1 1 0 1 1 0 1 1 0 1 1 0 1 1 0 1 1 0 1 1 0 1 1 0 1 1 0 1 1 0 1 1 0 1 1 0 1 1 0 1 1 0 1 1 0 1 1 0 1 9 0 1 1 0 1 1 0 1 1 0 1 1 0 1 1 0 1 1 0 1 1 0 1 1 0 1 1 0 1 1 0 1 1 0 1 1 0 1 1 0 1 1 0 15 1 0 16 1 1 16 1 1 16 1 0 16 1 0 16 1 0 16 1 0
16 1 0 16 1 1 17 1 0 1 1 0 1 1 0 1 1 0 1 1 0 1 1 0 1 1 0 25 1 0 26 1 0 27 1 0 1 1 0 1 1 0 1 1 0 1 1 0 1 1 0 1 9 0 1 1 0 1 1 0 1 1 0 1 1 0 1 1 0 1 1 0 1 1 0 1 1 0 1 1 0 1 1 0 1 1 0 1 1 0 1 1 0 1 1 0 1 1 0 1 1 0 1 1 0 1 1 0 1 1 0 1 1 0 1 1 0 1 1 0 1 1 0 1 1 0 1 1 0 1 1 0 1 1 0 1 1 0 1 1 0 1 1 0 1 1 0 1 1 0 1 1 0 1 1 0 1 1 0 1 1 0 1 1 0 1 1 0 1 1 0 25 1 0 19 1 0 16 1 1 16 1 0 16 1 0 16 1 0 16 1 0
16 1 0 16 1 1 17 1 0 1 1 0 1 1 0 1 1 0 1 1 0 1 1 0 1 1 0 1 1 0 1 1 0 1 1 0 1 1 0 1 1 0 1 1 0 1 1 0 1 1 0 1 1 0 1 1 0 1 1 0 1 1 0 1 1 0 1 9 0 1 1 0 1 1 0 1 1 0 1 1 0 1 1 0 5 1 0 6 1 0 6 1 0 6 1 0 6 1 0 6 1 0 6 1 0 7 1 0 1 1 0 1 1 0 1 1 0 1 1 0 1 1 0 1 1 0 1 1 0 1 1 0 1 1 0 1 1 0 1 1 0 1 1 0 1 1 0 1 1 0 1 1 0 1 1 0 1 1 0 1 1 0 1 1 0 1 1 0 1 1 0 1 1 0 15 1 0 16 1 1 16 1 0 16 1 0 16 1 0 16 1 0
16 1 0 16 1 1 28 1 0 7 1 0 1 1 0 1 1 0 1 9 0 1 1 0 1 1 0 1 1 0 1 1 0 1 1 0 1 1 0 1 1 0 1 1 0 1 1 0 1 1 0 1 1 0 1 1 0 1 1 0 1 1 0 1 1 0 1 1 0 1 1 0 1 1 0 5 1 0 6 1 0 6 1 0 29 1 0 16 1 1 16 1 1 16 1 1 16 1 1 16 1 1 16 1 1 28 1 0 7 1 0 1 1 0 1 1 0 1 1 0 1 1 0 1 1 0 1 1 0 1 1 0 1 1 0 1 1 0 1 1 0 1 1 0 1 1 0 1 1 0 1 1 0 1 1 0 5 1 0 6 1 0 7 1 0 1 1 0 1 1 0 1 1 0 15 1 0 16 1 1 16 1 1 16 1 0 16 1 0 16 1 0
16 1 0 16 1 1 16 1 1 17 1 0 1 1 0 1 1 0 1 1 0 1 1 0 1 1 0 1 1 0 1 1 0 1 1 0 1 1 0 1 1 0 1 1 0 1 1 0 1 1 0 1 1 0 1 1 0 1 1 0 1 1 0 1 1 0 1 1 0 5 1 0 6 1 0 29 1 0 16 1 1 16 1 1 16 1 1 16 1 1 16 1 1 16 1 1 16 1 1 16 1 1 16 1 1 16 1 1 28 1 0 7 1 0 1 1 0 1 1 0 1 1 0 1 1 0 1 1 0 1 1 0 1 1 0 1 1 0 1 1 0 1 1 0 1 1 0 1 1 0 5 1 0 6 1 0 29 1 0 16 1 1 28 1 0 7 1 0 1 1 0 1 1 0 25 1 0 19 1 0 16 1 1 16 1 1 16 1 0 16 1 0
16 1 0 16 1 1 18 1 0 27 1 0 1 1 0 1 1 0 1 1 0 1 1 0 1 1 0 1 1 0 1 1 0 1 1 0 1 1 0 1 1 0 1 9 0 1 1 0 1 1 0 1 1 0 1 1 0 1 1 0 1 1 0 1 1 0 5 1 0 29 1 0 16 1 1 16 1 1 16 1 1 18 1 0 26 1 0 26 1 0 26 1 0 26 1 0 19 1 0 16 1 1 16 1 0 16 1 1 16 1 1 17 1 0 1 1 0 1 1 0 1 1 0 1 1 0 1 1 0 1 1 0 1 1 0 1 1 0 1 1 0 1 1 0 1 1 0 1 1 0 25 1 0 19 1 0 16 1 1 16 1 1 18 1 0 27 1 0 1 1 0 1 1 0 1 1 0 25 1 0 19 1 0 16 1 1 16 1 1 16 1 0
16 1 0 16 1 1 17 1 0 1 1 0 1 1 0 1 1 0 1 1 0 1 1 0 1 1 0 1 1 0 1 1 0 1 1 0 1 1 0 1 1 0 1 9 0 1 1 0 1 1 0 1 1 0 1 1 0 1 1 0 1 1 0 1 1 0 15 1 0 16 1 1 16 1 1 16 1 0 16 1 1 17 1 0 2 1 0 3 9 0 3 9 0 4 1 0 15 1 0 16 1 1 16 1 0 16 1 0 16 1 1 17 1 0 1 1 0 1 1 0 1 1 0 1 1 0 1 1 0 1 1 0 1 1 0 1 1 0 1 1 0 1 1 0 1 1 0 1 1 0 1 1 0 25 1 0 26 1 0 26 1 0 27 1 0 1 1 0 1 1 0 1 1 0 1 1 0 1 1 0 25 1 0 19 1 0 16 1 1 16 1 0
16 1 0 16 1 1 17 1 0 1 1 0 1 1 0 1 1 0 1 1 0 1 1 0 5 1 0 6 1 0 6 1 0 6 1 0 7 1 0 1 1 0 1 1 0 1 1 0 1 1 0 1 1 0 1 1 0 1 1 0 1 1 0 5 1 0 29 1 0 16 1 1 16 1 0 16 1 0 16 1 1 17 1 0 12 1 0 13 9 0 13 9 0 14 1 0 15 1 0 16 1 1 16 1 0 16 1 0 16 1 1 17 1 0 1 1 0 1 1 0 1 1 0 1 1 0 1 1 0 1 1 0 1 1 0 1 1 0 1 1 0 1 1 0 1 1 0 1 1 0 1 1 0 1 1 0 1 1 0 1 1 0 1 1 0 1 1 0 1 1 0 1 1 0 1 1 0 1 1 0 1 1 0 15 1 0 16 1 1 16 1 0
16 1 0 16 1 1 28 1 0 7 1 0 1 1 0 1 1 0 5 1 0 6 1 0 29 1 0 16 1 1 16 1 1 16 1 1 28 1 0 6 1 0 6 1 0 6 1 0 6 1 0 6 1 0 6 1 0 6 1 0 6 1 0 29 1 0 16 1 1 16 1 1 16 1 0 16 1 0 16 1 1 17 1 0 12 1 0 13 9 0 13 9 0 14 1 0 15 1 0 16 1 1 16 1 0 16 1 0 16 1 1 17 1 0 1 1 0 1 1 0 1 1 0 1 1 0 1 1 0 1 1 0 1 1 0 1 1 0 1 1 0 1 1 0 1 1 0 1 1 0 1 1 0 1 1 0 1 1 0 1 1 0 1 1 0 1 1 0 1 1 0 1 1 0 1 1 0 1 1 0 1 1 0 15 1 0 16 1 1 16 1 0
16 1 0 16 1 1 16 1 1 28 1 0 6 1 0 6 1 0 29 1 0 16 1 1 16 1 1 16 1 1 16 1 0 16 1 1 16 1 1 16 1 1 16 1 1 16 1 1 16 1 1 16 1 1 16 1 1 16 1 1 16 1 1 16 1 1 16 1 1 16 1 1 16 1 0 16 1 0 16 1 1 17 1 0 22 1 0 11 1 0 10 1 0 24 1 0 15 1 0 16 1 1 16 1 0 16 1 0 16 1 1 17 1 0 1 1 0 1 1 0 1 1 0 1 1 0 1 1 0 1 1 0 1 1 0 1 1 0 1 1 0 1 1 0 1 1 0 1 1 0 1 1 0 1 1 0 1 1 0 1 1 0 1 1 0 1 1 0 1 9 0 1 1 0 1 1 0 1 1 0 1 1 0 15 1 0 16 1 1 16 1 0
16 1 0 16 1 0 16 1 1 16 1 1 16 1 1 16 1 1 16 1 1 16 1 1 16 1 1 16 1 1 16 1 1 16 1 1 16 1 1 16 1 1 16 1 0 16 1 0 16 1 0 16 1 0 16 1 1 16 1 1 16 1 1 18 1 0 19 1 0 16 1 1 16 1 1 16 1 0 16 1 1 28 1 0 7 1 0 12 1 0 14 1 0 5 1 0 29 1 0 16 1 1 16 1 0 16 1 1 16 1 1 17 1 0 1 1 0 1 1 0 1 1 0 1 1 0 1 1 0 1 1 0 1 1 0 1 1 0 1 1 0 1 1 0 1 1 0 1 1 0 1 1 0 1 1 0 1 1 0 1 1 0 1 1 0 1 1 0 1 1 0 1 1 0 1 1 0 1 1 0 1 1 0 15 1 0 16 1 1 16 1 0
16 1 0 16 1 0 16 1 1 16 1 1 16 1 1 18 1 0 26 1 0 26 1 0 26 1 0 26 1 0 26 1 0 26 1 0 19 1 0 16 1 1 16 1 1 16 1 1 16 1 1 16 1 1 16 1 1 18 1 0 26 1 0 27 1 0 25 1 0 19 1 0 16 1 1 16 1 1 16 1 1 16 1 1 17 1 0 12 1 0 14 1 0 15 1 0 16 1 1 16 1 1 16 1 1 16 1 1 18 1 0 27 1 0 1 1 0 1 1 0 1 1 0 1 9 0 1 1 0 1 1 0 1 1 0 1 1 0 1 1 0 1 1 0 1 1 0 1 1 0 1 1 0 1 1 0 1 1 0 1 1 0 1 1 0 1 1 0 1 1 0 1 1 0 1 1 0 1 1 0 1 1 0 15 1 0 16 1 1 16 1 0
16 1 0 16 1 1 16 1 1 18 1 0 26 1 0 27 1 0 1 1 0 1 1 0 1 1 0 1 1 0 1 1 0 1 1 0 25 1 0 26 1 0 26 1 0 26 1 0 26 1 0 26 1 0 26 1 0 27 1 0 1 1 0 1 1 0 1 1 0 25 1 0 19 1 0 16 1 1 16 1 1 16 1 1 17 1 0 12 1 0 14 1 0 15 1 0 16 1 1 16 1 1 18 1 0 26 1 0 27 1 0 1 1 0 1 1 0 1 1 0 1 1 0 1 1 0 1 1 0 1 1 0 1 1 0 1 1 0 2 1 0 3 1 0 3 1 0 3 1 0 3 1 0 4 1 0 1 1 0 1 1 0 1 1 0 1 1 0 1 1 0 1 1 0 1 1 0 1 1 0 1 1 0 15 1 0 16 1 1 16 1 0
16 1 0 16 1 1 18 1 0 27 1 0 1 1 0 2 1 0 3 1 0 3 1 0 3 1 0 4 1 0 1 1 0 1 1 0 1 1 0 1 1 0 1 1 0 1 1 0 1 1 0 1 1 0 1 1 0 1 1 0 1 1 0 1 1 0 1 1 0 1 1 0 25 1 0 26 1 0 26 1 0 26 1 0 27 1 0 12 1 0 14 1 0 25 1 0 26 1 0 26 1 0 27 1 0 1 1 0 1 1 0 1 1 0 1 1 0 1 1 0 1 1 0 1 1 0 1 1 0 1 1 0 1 1 0 2 1 0 21 1 0 13 1 0 13 1 0 13 1 0 13 1 0 20 1 0 4 1 0 1 1 0 1 1 0 1 1 0 1 1 0 1 1 0 1 1 0 1 1 0 1 1 0 15 1 0 16 1 1 16 1 0
16 1 1 16 1 1 17 1 0 1 1 0 1 1 0 12 1 0 13 1 0 13 1 0 13 1 0 20 1 0 3 1 0 3 1 0 4 1 0 1 1 0 1 1 0 1 1 0 1 1 0 1 1 0 1 1 0 1 1 0 1 1 0 1 1 0 1 1 0 1 1 0 1 1 0 1 1 0 1 1 0 1 1 0 2 1 0 21 1 0 20 1 0 4 1 0 1 1 0 1 1 0 1 1 0 1 1 0 1 1 0 1 1 0 1 1 0 1 1 0 1 1 0 1 1 0 1 1 0 1 1 0 2 1 0 21 1 0 13 1 0 13 1 0 13 1 0 10 1 0 11 1 0 13 1 0 20 1 0 4 1 0 1 1 0 1 1 0 1 1 0 1 1 0 1 1 0 1 1 0 1 1 0 15 1 0 16 1 1 16 1 0
16 1 1 18 1 0 27 1 0 1 1 0 1 1 0 12 1 0 13 1 0 13 1 0 13 1 0 13 1 0 13 1 0 13 1 0 14 1 0 1 1 0 1 1 0 1 1 0 1 1 0 1 1 0 1 1 0 1 1 0 1 1 0 1 9 0 1 1 0 1 1 0 1 1 0 1 1 0 1 1 0 1 1 0 12 1 0 13 1 0 10 1 0 24 1 0 1 1 0 1 1 0 1 1 0 1 1 0 1 1 0 1 1 0 1 9 0 1 1 0 1 1 0 1 1 0 1 1 0 1 1 0 12 1 0 13 1 0 13 1 0 13 1 0 13 1 0 20 1 0 21 1 0 13 1 0 13 1 0 14 1 0 1 1 0 1 1 0 1 1 0 1 9 0 1 1 0 1 1 0 1 1 0 15 1 0 16 1 1 16 1 0
16 1 1 17 1 0 1 1 0 1 1 0 1 1 0 22 1 0 11 1 0 13 1 0 13 1 0 13 1 0 13 1 0 10 1 0 24 1 0 1 1 0 1 1 0 1 1 0 1 1 0 1 1 0 1 1 0 1 1 0 1 1 0 1 1 0 1 1 0 1 1 0 1 1 0 1 1 0 1 1 0 1 1 0 22 1 0 23 1 0 24 1 0 1 1 0 1 1 0 1 1 0 1 1 0 1 1 0 1 1 0 1 1 0 1 1 0 1 1 0 1 1 0 1 1 0 1 1 0 1 1 0 12 1 0 13 1 0 13 1 0 13 1 0 13 1 0 13 1 0 13 1 0 13 1 0 13 1 0 14 1 0 1 1 0 1 1 0 1 1 0 1 1 0 1 1 0 1 1 0 1 1 0 15 1 0 16 1 1 16 1 0
16 1 1 17 1 0 1 1 0 1 1 0 1 9 0 1 1 0 22 1 0 23 1 0 23 1 0 23 1 0 23 1 0 24 1 0 1 1 0 1 1 0 1 1 0 1 1 0 1 1 0 1 9 0 1 1 0 1 1 0 1 1 0 1 1 0 1 1 0 1 1 0 1 1 0 1 1 0 1 1 0 1 1 0 1 1 0 1 1 0 1 1 0 1 1 0 1 1 0 1 1 0 1 1 0 1 1 0 1 1 0 1 1 0 1 1 0 1 1 0 1 1 0 1 1 0 1 1 0 1 1 0 22 1 0 11 1 0 13 1 0 13 1 0 13 1 0 13 1 0 13 1 0 13 1 0 10 1 0 24 1 0 1 1 0 1 1 0 1 1 0 1 1 0 1 1 0 1 1 0 1 1 0 15 1 0 16 1 1 16 1 0
16 1 1 17 1 0 1 1 0 1 1 0 1 1 0 1 1 0 1 1 0 1 1 0 1 1 0 1 1 0 1 1 0 1 1 0 1 1 0 1 1 0 1 1 0 1 1 0 1 1 0 1 1 0 1 1 0 1 1 0 1 1 0 1 1 0 1 1 0 1 1 0 1 1 0 1 1 0 1 1 0 1 1 0 1 1 0 1 1 0 1 1 0 1 1 0 1 1 0 1 1 0 1 1 0 1 1 0 1 1 0 1 1 0 1 1 0 1 1 0 1 1 0 1 1 0 1 1 0 1 1 0 1 1 0 22 1 0 23 1 0 11 1 0 13 1 0 13 1 0 13 1 0 10 1 0 24 1 0 1 1 0 1 1 0 1 1 0 1 1 0 1 1 0 1 1 0 1 1 0 5 1 0 29 1 0 16 1 1 16 1 0
16 1 1 17 1 0 1 1 0 1 1 0 1 1 0 1 1 0 1 1 0 1 1 0 1 1 0 1 1 0 1 1 0 1 1 0 1 1 0 1 1 0 1 1 0 1 1 0 1 1 0 1 1 0 1 1 0 1 1 0 1 9 0 1 1 0 1 1 0 1 1 0 1 1 0 1 1 0 1 1 0 1 1 0 1 1 0 1 1 0 1 1 0 1 9 0 1 1 0 1 1 0 1 1 0 1 1 0 1 1 0 1 1 0 1 1 0 1 1 0 1 1 0 1 1 0 1 1 0 1 1 0 1 1 0 1 1 0 1 1 0 22 1 0 23 1 0 23 1 0 23 1 0 24 1 0 1 1 0 1 1 0 1 1 0 1 1 0 1 1 0 1 1 0 1 1 0 1 1 0 15 1 0 16 1 1 16 1 1 16 1 0
16 1 1 28 1 0 7 1 0 1 1 0 1 1 0 1 1 0 1 1 0 1 1 0 1 1 0 1 1 0 1 1 0 1 1 0 1 1 0 1 1 0 1 1 0 1 1 0 1 1 0 1 1 0 1 1 0 1 1 0 1 1 0 1 1 0 1 1 0 1 1 0 1 1 0 1 1 0 1 1 0 1 1 0 1 1 0 1 1 0 1 1 0 1 1 0 1 1 0 1 1 0 1 1 0 1 1 0 1 1 0 1 1 0 1 1 0 1 1 0 1 1 0 1 1 0 1 1 0 1 1 0 1 1 0 1 1 0 1 1 0 1 1 0 1 1 0 1 1 0 1 1 0 1 1 0 1 1 0 1 1 0 1 1 0 1 1 0 1 1 0 1 1 0 1 1 0 5 1 0 29 1 0 16 1 1 16 1 0 16 1 0
16 1 1 16 1 1 28 1 0 7 1 0 1 1 0 1 1 0 1 1 0 1 1 0 1 1 0 1 1 0 1 1 0 1 9 0 1 1 0 1 1 0 1 1 0 1 1 0 1 1 0 1 1 0 1 1 0 1 1 0 1 1 0 1 1 0 1 1 0 1 1 0 1 1 0 1 1 0 5 1 0 6 1 0 6 1 0 6 1 0 6 1 0 6 1 0 7 1 0 1 1 0 1 1 0 1 1 0 1 1 0 1 1 0 1 1 0 1 1 0 1 1 0 1 1 0 1 1 0 1 1 0 1 1 0 1 1 0 1 1 0 1 1 0 1 1 0 1 1 0 1 1 0 1 1 0 1 1 0 1 1 0 1 1 0 1 1 0 1 1 0 5 1 0 6 1 0 29 1 0 16 1 1 16 1 1 16 1 0 16 1 0
16 1 0 16 1 1 16 1 1 28 1 0 6 1 0 7 1 0 1 1 0 1 1 0 1 1 0 1 1 0 1 1 0 1 1 0 1 1 0 1 1 0 1 1 0 1 1 0 1 1 0 1 1 0 1 1 0 1 1 0 1 1 0 1 1 0 1 1 0 1 1 0 5 1 0 6 1 0 29 1 0 16 1 1 16 1 1 16 1 1 16 1 1 16 1 1 28 1 0 7 1 0 1 1 0 1 1 0 1 1 0 1 1 0 1 1 0 1 1 0 1 1 0 1 1 0 1 9 0 1 1 0 1 1 0 1 1 0 1 1 0 1 1 0 1 1 0 1 9 0 1 1 0 1 1 0 1 1 0 1 1 0 1 1 0 5 1 0 6 1 0 29 1 0 16 1 1 16 1 1 16 1 1 16 1 0 16 1 0 16 1 0
16 1 0 16 1 0 16 1 1 16 1 1 16 1 1 28 1 0 6 1 0 7 1 0 1 1 0 1 1 0 1 1 0 1 1 0 1 1 0 1 1 0 1 1 0 1 1 0 1 1 0 1 1 0 1 1 0 1 1 0 1 1 0 1 1 0 5 1 0 6 1 0 29 1 0 16 1 1 16 1 1 16 1 1 16 1 0 16 1 0 16 1 0 16 1 1 16 1 1 28 1 0 6 1 0 7 1 0 1 1 0 1 1 0 1 1 0 1 1 0 1 1 0 1 1 0 1 1 0 1 1 0 1 1 0 1 1 0 1 1 0 1 1 0 1 1 0 1 1 0 1 1 0 1 1 0 1 1 0 1 1 0 5 1 0 29 1 0 16 1 1 16 1 1 16 1 1 16 1 0 16 1 0 16 1 0 16 1 0 16 1 0
16 1 0 16 1 0 16 1 0 16 1 0 16 1 1 16 1 1 16 1 1 28 1 0 6 1 0 6 1 0 7 1 0 1 1 0 1 1 0 1 1 0 1 1 0 1 1 0 1 1 0 1 1 0 1 1 0 1 1 0 1 1 0 5 1 0 29 1 0 16 1 1 16 1 1 16 1 1 16 1 0 16 1 0 16 1 0 16 1 0 16 1 0 16 1 0 16 1 1 16 1 1 16 1 1 28 1 0 6 1 0 7 1 0 1 1 0 1 1 0 1 1 0 1 1 0 1 1 0 1 1 0 1 1 0 1 1 0 1 1 0 1 1 0 1 1 0 1 1 0 1 1 0 1 1 0 5 1 0 6 1 0 29 1 0 16 1 1 16 1 1 16 1 0 16 1 0 16 1 0 16 1 0 16 1 0 16 1 0 16 1 0
16 1 0 16 1 0 16 1 0 16 1 0 16 1 0 16 1 0 16 1 1 16 1 1 16 1 1 16 1 1 28 1 0 6 1 0 6 1 0 7 1 0 1 1 0 1 1 0 1 1 0 1 1 0 5 1 0 6 1 0 6 1 0 29 1 0 16 1 1 16 1 1 16 1 0 16 1 0 16 1 0 16 1 0 16 1 0 16 1 0 16 1 0 16 1 0 16 1 0 16 1 0 16 1 1 16 1 1 16 1 1 28 1 0 6 1 0 7 1 0 1 1 0 1 1 0 1 1 0 1 1 0 1 1 0 1 1 0 1 1 0 1 1 0 1 1 0 5 1 0 6 1 0 6 1 0 29 1 0 16 1 1 16 1 1 16 1 1 16 1 0 16 1 0 16 1 0 16 1 0 16 1 0 16 1 0 16 1 0 16 1 0
16 1 0 16 1 0 16 1 0 16 1 0 16 1 0 16 1 0 16 1 0 16 1 0 16 1 0 16 1 1 16 1 1 16 1 1 16 1 1 28 1 0 6 1 0 6 1 0 6 1 0 6 1 0 29 1 0 16 1 1 16 1 1 16 1 1 16 1 1 16 1 0 16 1 0 16 1 0 16 1 0 16 1 0 16 1 0 16 1 0 16 1 0 16 1 0 16 1 0 16 1 0 16 1 0 16 1 0 16 1 1 16 1 1 16 1 1 28 1 0 6 1 0 6 1 0 6 1 0 6 1 0 6 1 0 6 1 0 6 1 0 6 1 0 6 1 0 29 1 0 16 1 1 16 1 1 16 1 1 16 1 1 16 1 0 16 1 0 16 1 0 16 1 0 16 1 0 16 1 0 16 1 0 16 1 0 16 1 0 16 1 0
16 1 0 16 1 0 16 1 0 16 1 0 16 1 0 16 1 0 16 1 0 16 1 0 16 1 0 16 1 0 16 1 0 16 1 0 16 1 1 16 1 1 16 1 1 16 1 1 16 1 1 16 1 1 16 1 1 16 1 1 16 1 0 16 1 0 16 1 0 16 1 0 16 1 0 16 1 0 16 1 0 16 1 0 16 1 0 16 1 0 16 1 0 16 1 0 16 1 0 16 1 0 16 1 0 16 1 0 16 1 0 16 1 0 16 1 1 16 1 1 16 1 1 16 1 1 16 1 1 16 1 1 16 1 1 16 1 1 16 1 1 16 1 1 16 1 1 16 1 1 16 1 1 16 1 0 16 1 0 16 1 0 16 1 0 16 1 0 16 1 0 16 1 0 16 1 0 16 1 0 16 1 0 16 1 0 16 1 0 16 1 0