64 64 0
16 0 16 0 16 0 16 0 16 1 16 1 16 1 16 1 16 1 16 1 16 1 16 1 16 0 16 0 16 0 16 0 16 0 16 0 16 0 16 0 16 0 16 0 16 0 16 0 16 0 16 0 16 0 16 0 16 0 16 0 16 0 16 0 16 0 16 0 16 0 16 0 16 0 16 0 16 0 16 0 16 0 16 0 16 0 16 0 16 0 16 0 16 0 16 0 16 0 16 0 16 0 16 0 16 0 16 0 16 0 16 0 16 0 16 0 16 0 16 0 16 0 16 0 16 0 16 0
16 0 16 0 16 0 16 1 16 1 18 0 26 0 26 0 26 0 26 0 19 0 16 1 16 1 16 0 16 0 16 0 16 0 16 0 16 0 16 0 16 0 16 0 16 0 16 0 16 0 16 0 16 0 16 0 16 0 16 0 16 0 16 0 16 0 16 0 16 1 16 1 16 1 16 1 16 1 16 1 16 1 16 1 16 1 16 1 16 1 16 1 16 0 16 0 16 0 16 0 16 0 16 0 16 0 16 0 16 0 16 1 16 1 16 1 16 1 16 1 16 1 16 1 16 0 16 0
16 0 16 0 16 1 16 1 18 0 27 0 1 0 1 0 1 0 1 0 25 0 19 0 16 1 16 0 16 0 16 0 16 0 16 0 16 0 16 0 16 0 16 0 16 0 16 0 16 0 16 1 16 1 16 1 16 1 16 1 16 1 16 1 16 1 16 1 16 1 18 0 26 0 26 0 26 0 26 0 26 0 26 0 26 0 26 0 19 0 16 1 16 1 16 1 16 1 16 0 16 0 16 0 16 1 16 1 16 1 16 1 18 0 26 0 26 0 26 0 19 0 16 1 16 1 16 0
16 0 16 0 16 1 18 0 27 0 1 0 1 0 1 0 1 0 1 0 1 0 15 0 16 1 16 0 16 0 16 0 16 0 16 0 16 0 16 0 16 0 16 0 16 0 16 0 16 1 16 1 18 0 26 0 26 0 26 0 26 0 26 0 26 0 26 0 26 0 27 0 1 0 1 0 1 0 1 0 1 0 1 0 1 0 1 0 25 0 26 0 26 0 19 0 16 1 16 1 16 1 16 1 16 1 18 0 26 0 26 0 27 0 1 0 1 0 1 0 25 0 19 0 16 1 16 1
16 0 16 1 16 1 17 0 1 0 1 0 1 0 1 0 1 0 1 0 1 0 15 0 16 1 16 1 16 0 16 0 16 0 16 0 16 0 16 1 16 1 16 1 16 1 16 1 16 1 18 0 27 0 1 0 1 0 1 0 1 0 1 0 1 0 1 0 1 0 1 0 2 0 4 0 1 0 1 0 1 0 1 0 1 0 1 0 1 0 1 0 1 0 25 0 26 0 26 0 26 0 26 0 26 0 27 0 1 0 1 0 1 0 1 0 1 0 1 0 1 0 25 0 19 0 16 1
16 0 16 1 18 0 27 0 1 0 1 0 1 0 1 0 1 0 1 0 1 0 25 0 19 0 16 1 16 1 16 1 16 1 16 1 16 1 16 1 18 0 26 0 26 0 26 0 26 0 27 0 1 0 1 0 1 0 1 0 1 0 1 0 1 0 2 0 3 0 3 0 21 0 20 0 4 0 1 0 1 0 1 0 1 0 1 0 1 0 1 0 1 0 1 0 1 0 1 0 1 0 1 0 1 0 1 0 1 0 1 0 1 0 1 0 1 0 1 0 1 0 1 0 15 0 16 1
16 0 16 1 17 0 1 0 1 0 1 0 1 0 1 0 1 0 1 0 1 0 1 0 25 0 26 0 26 0 19 0 16 1 18 0 26 0 26 0 27 0 1 0 1 0 1 0 1 0 1 0 1 0 1 0 1 0 1 0 1 0 1 0 2 0 21 0 13 0 13 0 13 0 13 0 14 0 1 0 1 0 1 0 1 0 1 0 1 0 1 0 1 0 1 0 1 0 1 0 1 0 1 0 1 0 1 0 1 0 1 0 1 0 1 0 1 0 1 0 1 0 1 0 15 0 16 1
16 0 16 1 17 0 1 0 1 0 1 0 1 0 1 0 1 0 1 0 1 0 1 0 1 0 1 0 1 0 25 0 26 0 27 0 1 0 1 0 1 0 1 0 1 0 1 0 1 0 1 0 1 0 1 0 1 0 1 0 1 0 1 0 12 0 13 0 13 0 13 0 13 0 13 0 14 0 1 0 1 0 1 0 1 0 1 0 1 0 1 0 1 0 1 0 1 0 1 0 1 0 1 0 1 0 1 0 1 0 1 0 1 0 1 0 1 0 1 0 1 0 5 0 29 0 16 1
16 0 16 1 28 0 7 0 1 0 1 0 1 0 1 0 1 0 1 0 1 0 1 0 1 0 1 0 1 0 1 0 1 0 1 0 1 0 1 0 1 0 1 0 1 0 1 0 1 0 1 0 1 0 1 0 1 0 1 0 1 0 1 0 12 0 13 0 13 0 13 0 10 0 23 0 24 0 1 0 1 0 1 0 1 0 1 0 1 0 1 0 1 0 1 0 1 0 1 0 5 0 6 0 7 0 1 0 1 0 1 0 1 0 1 0 1 0 1 0 5 0 29 0 16 1 16 1
16 0 16 1 16 1 28 0 6 0 6 0 6 0 7 0 1 0 1 0 1 0 1 0 1 0 1 0 1 0 1 0 1 0 1 0 1 0 1 0 1 0 1 0 1 0 1 0 1 0 1 0 1 0 1 0 1 0 1 0 1 0 1 0 22 0 23 0 23 0 23 0 24 0 1 0 1 0 1 0 1 0 1 0 1 0 1 0 1 0 1 0 1 0 1 0 1 0 5 0 29 0 16 1 28 0 6 0 7 0 1 0 1 0 1 0 1 0 1 0 15 0 16 1 16 1 16 0
16 0 16 0 16 1 16 1 16 1 16 1 16 1 28 0 7 0 1 0 1 0 1 0 1 0 1 0 1 0 1 0 1 0 1 0 1 0 1 0 1 0 1 0 1 0 1 0 1 0 1 0 1 0 1 0 1 0 1 0 1 0 1 0 1 0 1 0 1 0 1 0 1 0 1 0 1 0 1 0 1 0 1 0 1 0 1 0 1 0 1 0 1 0 1 0 1 0 15 0 16 1 16 1 16 1 16 1 28 0 7 0 1 0 1 0 1 0 1 0 15 0 16 1 16 0 16 0
16 0 16 0 16 0 16 0 16 0 16 0 16 1 16 1 28 0 7 0 1 0 1 0 1 0 2 0 3 0 3 0 4 0 1 0 1 0 1 0 1 0 1 0 5 0 6 0 7 0 1 0 1 0 1 0 1 0 1 0 1 0 1 0 1 0 1 0 1 0 1 0 1 0 1 0 1 0 1 0 1 0 1 0 1 0 1 0 1 0 1 0 1 0 1 0 1 0 25 0 26 0 19 0 16 1 18 0 26 0 27 0 1 0 1 0 1 0 1 0 15 0 16 1 16 0 16 0
16 0 16 0 16 0 16 0 16 0 16 0 16 0 16 1 18 0 27 0 1 0 2 0 3 0 21 0 13 0 13 0 14 0 1 0 1 0 1 0 1 0 5 0 29 0 16 1 28 0 7 0 1 0 1 0 1 0 1 0 1 0 1 0 1 0 1 0 1 0 1 0 1 0 1 0 1 0 1 0 1 0 1 0 1 0 1 0 1 0 1 0 1 0 1 0 1 0 1 0 1 0 25 0 26 0 27 0 1 0 1 0 1 0 1 0 1 0 1 0 15 0 16 1 16 0 16 0
16 0 16 0 16 0 16 0 16 0 16 1 16 1 16 1 17 0 1 0 1 0 12 0 13 0 13 0 13 0 13 0 14 0 1 0 1 0 1 0 1 0 25 0 19 0 18 0 26 0 27 0 1 0 1 0 1 0 1 0 1 0 1 0 1 0 1 0 1 0 1 0 1 0 1 0 1 0 1 0 1 0 1 0 1 0 1 0 1 0 1 0 1 0 1 0 1 0 1 0 1 0 1 0 1 0 1 0 1 0 1 0 1 0 1 0 1 0 1 0 15 0 16 1 16 1 16 0
16 0 16 0 16 0 16 0 16 1 16 1 18 0 26 0 27 0 1 0 1 0 12 0 13 0 13 0 13 0 10 0 24 0 1 0 1 0 1 0 1 0 1 0 25 0 27 0 1 0 1 0 1 0 1 0 1 0 1 0 1 0 1 0 1 0 1 0 1 0 1 0 5 0 6 0 6 0 7 0 1 0 1 0 1 0 1 0 1 0 1 0 1 0 1 0 1 0 1 0 1 0 1 0 1 0 1 0 1 0 1 0 1 0 1 0 1 0 1 0 25 0 19 0 16 1 16 0
16 0 16 0 16 0 16 0 16 1 18 0 27 0 1 0 1 0 1 0 2 0 21 0 13 0 13 0 10 0 24 0 1 0 1 0 1 0 1 0 1 0 1 0 1 0 1 0 1 0 1 0 1 0 1 0 1 0 1 0 1 0 1 0 1 0 5 0 6 0 6 0 29 0 16 1 16 1 28 0 6 0 6 0 6 0 7 0 1 0 1 0 1 0 1 0 1 0 1 0 1 0 1 0 1 0 1 0 1 0 1 0 1 0 1 0 1 0 1 0 1 0 15 0 16 1 16 0
16 0 16 0 16 0 16 0 16 1 17 0 1 0 1 0 1 0 1 0 12 0 13 0 13 0 13 0 14 0 1 0 1 0 1 0 1 0 1 0 1 0 1 0 1 0 1 0 1 0 1 0 1 0 1 0 1 0 1 0 1 0 1 0 1 0 15 0 16 1 16 1 16 1 16 1 16 1 16 1 16 1 16 1 16 1 28 0 6 0 6 0 7 0 1 0 1 0 1 0 1 0 1 0 1 0 1 0 1 0 1 0 1 0 1 0 1 0 1 0 1 0 15 0 16 1 16 0
16 0 16 0 16 0 16 0 16 1 17 0 1 0 1 0 1 0 1 0 22 0 23 0 23 0 23 0 24 0 1 0 1 0 1 0 1 0 1 0 1 0 1 0 1 0 1 0 1 0 1 0 1 0 1 0 1 0 1 0 1 0 1 0 5 0 29 0 16 1 16 0 16 0 16 0 16 0 16 0 16 0 16 0 16 1 16 1 16 1 16 1 28 0 6 0 6 0 7 0 1 0 1 0 1 0 1 0 1 0 1 0 1 0 1 0 1 0 1 0 5 0 29 0 16 1 16 0
16 0 16 0 16 0 16 0 16 1 17 0 1 0 1 0 1 0 1 0 1 0 1 0 1 0 1 0 1 0 1 0 1 0 1 0 1 0 1 0 1 0 1 0 1 0 1 0 1 0 1 0 1 0 1 0 1 0 1 0 1 0 1 0 15 0 16 1 16 1 16 0 16 0 16 0 16 0 16 0 16 0 16 0 16 0 16 0 16 0 16 1 16 1 16 1 16 1 28 0 6 0 6 0 7 0 1 0 1 0 1 0 1 0 1 0 1 0 1 0 15 0 16 1 16 1 16 0
16 0 16 0 16 0 16 0 16 1 17 0 1 0 1 0 1 0 1 0 1 0 1 0 1 0 1 0 1 0 1 0 1 0 1 0 1 0 1 0 1 0 1 0 1 0 1 0 1 0 1 0 1 0 1 0 1 0 1 0 1 0 1 0 25 0 19 0 16 1 16 0 16 0 16 0 16 0 16 0 16 0 16 0 16 0 16 0 16 0 16 0 16 0 16 0 16 1 16 1 16 1 16 1 28 0 6 0 7 0 1 0 1 0 1 0 1 0 1 0 15 0 16 1 16 0 16 0
16 0 16 0 16 0 16 1 16 1 17 0 1 0 1 0 1 0 1 0 1 0 1 0 1 0 1 0 1 0 1 0 1 0 1 0 1 0 1 0 1 0 1 0 1 0 1 0 1 0 1 0 1 0 1 0 1 0 1 0 1 0 1 0 1 0 15 0 16 1 16 1 16 0 16 0 16 0 16 0 16 0 16 0 16 0 16 0 16 0 16 0 16 0 16 0 16 0 16 0 16 0 16 1 16 1 16 1 28 0 6 0 6 0 6 0 6 0 6 0 29 0 16 1 16 0 16 0
16 0 16 0 16 1 16 1 18 0 27 0 1 0 1 0 1 0 1 0 1 0 1 0 1 0 5 0 6 0 6 0 6 0 6 0 6 0 7 0 1 0 1 0 1 0 1 0 1 0 1 0 1 0 1 0 1 0 1 0 1 0 1 0 1 0 25 0 19 0 16 1 16 0 16 0 16 0 16 0 16 0 16 0 16 0 16 0 16 0 16 0 16 0 16 0 16 0 16 0 16 0 16 1 16 1 16 1 16 1 16 1 16 1 16 1 16 1 16 1 16 1 16 1 16 0 16 0
16 0 16 1 16 1 18 0 27 0 1 0 1 0 1 0 1 0 1 0 1 0 1 0 5 0 29 0 16 1 16 1 16 1 16 1 16 1 28 0 7 0 1 0 1 0 1 0 1 0 1 0 1 0 1 0 1 0 1 0 1 0 1 0 1 0 1 0 15 0 16 1 16 1 16 1 16 1 16 0 16 0 16 0 16 0 16 0 16 0 16 0 16 1 16 1 16 1 16 1 16 1 16 1 18 0 26 0 26 0 26 0 26 0 26 0 26 0 19 0 16 1 16 0 16 0 16 0
16 0 16 1 18 0 27 0 1 0 1 0 1 0 1 0 1 0 1 0 1 0 1 0 15 0 16 1 16 1 16 0 16 0 16 0 16 1 16 1 17 0 1 0 1 0 1 0 1 0 1 0 1 0 1 0 1 0 1 0 1 0 1 0 1 0 1 0 25 0 26 0 26 0 19 0 16 1 16 1 16 1 16 1 16 1 16 1 16 1 16 1 16 1 18 0 26 0 26 0 26 0 26 0 27 0 1 0 1 0 1 0 1 0 1 0 1 0 15 0 16 1 16 0 16 0 16 0
16 0 16 1 17 0 1 0 1 0 1 0 1 0 1 0 1 0 1 0 1 0 1 0 25 0 19 0 16 1 16 0 16 0 16 0 16 1 18 0 27 0 1 0 1 0 1 0 1 0 1 0 1 0 1 0 1 0 1 0 1 0 1 0 1 0 1 0 1 0 1 0 1 0 25 0 26 0 26 0 26 0 26 0 26 0 26 0 26 0 26 0 26 0 27 0 1 0 1 0 1 0 1 0 1 0 1 0 1 0 1 0 1 0 1 0 1 0 15 0 16 1 16 0 16 0 16 0
16 0 16 1 28 0 7 0 1 0 1 0 1 0 1 0 1 0 1 0 1 0 1 0 1 0 15 0 16 1 16 1 16 0 16 1 16 1 17 0 1 0 1 0 1 0 1 0 1 0 1 0 1 0 1 0 1 0 1 0 1 0 1 0 1 0 1 0 1 0 1 0 1 0 1 0 1 0 1 0 1 0 1 0 1 0 1 0 1 0 1 0 1 0 1 0 1 0 1 0 1 0 1 0 1 0 1 0 1 0 1 0 1 0 1 0 1 0 15 0 16 1 16 0 16 0 16 0
16 0 16 1 16 1 17 0 1 0 1 0 1 0 1 0 1 0 1 0 1 0 1 0 1 0 25 0 19 0 16 1 16 1 16 1 18 0 27 0 1 0 1 0 1 0 1 0 1 0 1 0 1 0 1 0 1 0 1 0 1 0 1 0 1 0 1 0 1 0 1 0 1 0 1 0 1 0 1 0 1 0 1 0 1 0 1 0 1 0 1 0 1 0 1 0 1 0 1 0 1 0 1 0 1 0 1 0 1 0 1 0 1 0 1 0 1 0 15 0 16 1 16 0 16 0 16 0
16 0 16 0 16 1 17 0 1 0 1 0 1 0 1 0 1 0 1 0 1 0 1 0 1 0 1 0 25 0 26 0 26 0 26 0 27 0 1 0 1 0 1 0 1 0 1 0 1 0 1 0 1 0 1 0 1 0 1 0 1 0 1 0 1 0 1 0 1 0 1 0 1 0 1 0 1 0 1 0 1 0 1 0 1 0 1 0 1 0 1 0 1 0 1 0 1 0 1 0 2 0 3 0 4 0 1 0 1 0 1 0 1 0 1 0 1 0 15 0 16 1 16 0 16 0 16 0
16 0 16 0 16 1 17 0 1 0 1 0 1 0 1 0 1 0 1 0 1 0 1 0 1 0 1 0 1 0 1 0 1 0 1 0 1 0 1 0 1 0 1 0 1 0 1 0 2 0 3 0 3 0 3 0 4 0 2 0 3 0 4 0 1 0 1 0 1 0 1 0 1 0 1 0 1 0 1 0 1 0 1 0 1 0 1 0 1 0 2 0 3 0 3 0 3 0 3 0 21 0 13 0 20 0 4 0 1 0 1 0 1 0 1 0 1 0 15 0 16 1 16 0 16 0 16 0
16 0 16 0 16 1 17 0 1 0 1 0 1 0 1 0 1 0 1 0 1 0 1 0 1 0 1 0 1 0 1 0 1 0 1 0 1 0 1 0 1 0 1 0 1 0 2 0 21 0 13 0 13 0 13 0 20 0 21 0 13 0 14 0 1 0 1 0 1 0 1 0 1 0 1 0 1 0 1 0 1 0 1 0 1 0 2 0 3 0 21 0 13 0 13 0 13 0 13 0 13 0 13 0 13 0 14 0 1 0 1 0 1 0 1 0 1 0 15 0 16 1 16 0 16 0 16 0
16 0 16 0 16 1 17 0 1 0 1 0 1 0 1 0 1 0 1 0 1 0 1 0 1 0 1 0 1 0 1 0 1 0 1 0 1 0 1 0 1 0 1 0 1 0 12 0 13 0 13 0 13 0 13 0 13 0 13 0 10 0 24 0 1 0 1 0 1 0 1 0 1 0 1 0 1 0 1 0 1 0 1 0 1 0 12 0 13 0 13 0 13 0 13 0 13 0 13 0 13 0 13 0 10 0 24 0 1 0 1 0 1 0 1 0 5 0 29 0 16 1 16 0 16 0 16 0
16 0 16 0 16 1 17 0 1 0 1 0 1 0 1 0 1 0 1 0 1 0 1 0 1 0 1 0 1 0 1 0 1 0 1 0 1 0 1 0 1 0 1 0 2 0 21 0 13 0 13 0 13 0 13 0 13 0 13 0 14 0 1 0 1 0 1 0 1 0 1 0 1 0 1 0 1 0 1 0 1 0 1 0 1 0 12 0 13 0 13 0 13 0 13 0 10 0 23 0 23 0 23 0 24 0 1 0 1 0 1 0 1 0 1 0 15 0 16 1 16 1 16 0 16 0 16 0
16 0 16 0 16 1 17 0 1 0 1 0 1 0 1 0 1 0 1 0 1 0 1 0 1 0 1 0 1 0 1 0 1 0 1 0 1 0 1 0 1 0 1 0 12 0 13 0 13 0 13 0 13 0 13 0 13 0 10 0 24 0 1 0 1 0 1 0 1 0 1 0 1 0 1 0 1 0 1 0 1 0 1 0 1 0 22 0 23 0 23 0 23 0 23 0 24 0 1 0 1 0 1 0 1 0 1 0 1 0 1 0 1 0 1 0 15 0 16 1 16 0 16 0 16 0 16 0
16 0 16 0 16 1 17 0 1 0 1 0 1 0 1 0 1 0 1 0 1 0 1 0 1 0 1 0 1 0 1 0 1 0 1 0 1 0 1 0 1 0 1 0 12 0 13 0 13 0 13 0 10 0 23 0 23 0 24 0 1 0 1 0 1 0 1 0 1 0 1 0 1 0 1 0 1 0 1 0 1 0 1 0 1 0 1 0 1 0 1 0 1 0 1 0 1 0 1 0 1 0 1 0 1 0 1 0 1 0 1 0 1 0 5 0 29 0 16 1 16 0 16 0 16 0 16 0
16 0 16 1 16 1 17 0 1 0 1 0 1 0 1 0 1 0 5 0 6 0 7 0 1 0 1 0 1 0 1 0 1 0 1 0 1 0 1 0 1 0 1 0 22 0 11 0 13 0 13 0 14 0 1 0 1 0 1 0 1 0 1 0 1 0 1 0 1 0 1 0 1 0 1 0 1 0 1 0 1 0 1 0 1 0 1 0 1 0 1 0 1 0 1 0 1 0 1 0 1 0 1 0 1 0 1 0 1 0 1 0 1 0 15 0 16 1 16 1 16 0 16 0 16 0 16 0
16 0 16 1 18 0 27 0 1 0 1 0 1 0 1 0 5 0 29 0 16 1 28 0 7 0 1 0 1 0 1 0 1 0 1 0 1 0 1 0 1 0 1 0 1 0 22 0 23 0 23 0 24 0 1 0 1 0 1 0 1 0 1 0 1 0 1 0 1 0 1 0 1 0 1 0 1 0 1 0 1 0 1 0 1 0 1 0 1 0 1 0 1 0 1 0 1 0 1 0 1 0 1 0 1 0 1 0 1 0 1 0 1 0 15 0 16 1 16 0 16 0 16 0 16 0 16 0
16 0 16 1 17 0 1 0 1 0 1 0 1 0 1 0 25 0 19 0 16 1 18 0 27 0 1 0 1 0 1 0 1 0 1 0 1 0 1 0 1 0 1 0 1 0 1 0 1 0 1 0 1 0 1 0 1 0 1 0 1 0 1 0 1 0 1 0 1 0 1 0 1 0 1 0 1 0 1 0 1 0 1 0 1 0 1 0 1 0 1 0 1 0 1 0 1 0 1 0 1 0 1 0 1 0 1 0 1 0 1 0 1 0 15 0 16 1 16 1 16 0 16 0 16 0 16 0
16 0 16 1 17 0 1 0 1 0 1 0 1 0 1 0 1 0 25 0 26 0 27 0 1 0 1 0 1 0 1 0 1 0 1 0 1 0 1 0 1 0 1 0 1 0 1 0 1 0 1 0 1 0 1 0 1 0 1 0 1 0 1 0 1 0 1 0 1 0 1 0 1 0 1 0 1 0 1 0 1 0 1 0 1 0 1 0 1 0 1 0 1 0 1 0 1 0 1 0 1 0 1 0 1 0 1 0 1 0 1 0 1 0 25 0 19 0 16 1 16 0 16 0 16 0 16 0
16 0 16 1 17 0 1 0 1 0 1 0 1 0 1 0 1 0 1 0 1 0 1 0 1 0 1 0 1 0 1 0 1 0 1 0 1 0 1 0 1 0 1 0 1 0 1 0 1 0 1 0 1 0 1 0 5 0 6 0 6 0 6 0 6 0 6 0 6 0 7 0 1 0 1 0 1 0 1 0 1 0 1 0 1 0 1 0 1 0 1 0 1 0 1 0 1 0 1 0 1 0 1 0 1 0 1 0 1 0 1 0 1 0 1 0 15 0 16 1 16 0 16 0 16 0 16 0
16 0 16 1 28 0 7 0 1 0 1 0 1 0 1 0 1 0 1 0 1 0 1 0 1 0 1 0 1 0 1 0 1 0 1 0 1 0 1 0 1 0 1 0 1 0 1 0 1 0 5 0 6 0 6 0 29 0 16 1 16 1 16 1 16 1 16 1 16 1 28 0 7 0 1 0 1 0 1 0 1 0 1 0 1 0 1 0 1 0 1 0 1 0 1 0 1 0 1 0 1 0 1 0 5 0 6 0 7 0 1 0 1 0 1 0 15 0 16 1 16 1 16 0 16 0 16 0
16 0 16 1 16 1 17 0 1 0 1 0 1 0 1 0 1 0 1 0 1 0 1 0 1 0 1 0 1 0 1 0 1 0 1 0 1 0 1 0 1 0 1 0 1 0 5 0 6 0 29 0 16 1 16 1 16 1 16 1 16 1 16 1 16 1 16 1 16 1 16 1 28 0 7 0 1 0 1 0 1 0 1 0 1 0 1 0 1 0 1 0 1 0 1 0 1 0 1 0 5 0 6 0 29 0 16 1 28 0 7 0 1 0 1 0 25 0 19 0 16 1 16 1 16 0 16 0
16 0 16 1 18 0 27 0 1 0 1 0 1 0 1 0 1 0 1 0 1 0 1 0 1 0 1 0 1 0 1 0 1 0 1 0 1 0 1 0 1 0 1 0 5 0 29 0 16 1 16 1 16 1 18 0 26 0 26 0 26 0 26 0 19 0 16 1 16 0 16 1 16 1 17 0 1 0 1 0 1 0 1 0 1 0 1 0 1 0 1 0 1 0 1 0 1 0 1 0 25 0 19 0 16 1 16 1 18 0 27 0 1 0 1 0 1 0 25 0 19 0 16 1 16 1 16 0
16 0 16 1 17 0 1 0 1 0 1 0 1 0 1 0 1 0 1 0 1 0 1 0 1 0 1 0 1 0 1 0 1 0 1 0 1 0 1 0 1 0 1 0 15 0 16 1 16 1 16 0 16 1 17 0 2 0 3 0 3 0 4 0 15 0 16 1 16 0 16 0 16 1 17 0 1 0 1 0 1 0 1 0 1 0 1 0 1 0 1 0 1 0 1 0 1 0 1 0 1 0 25 0 26 0 26 0 27 0 1 0 1 0 1 0 1 0 1 0 25 0 19 0 16 1 16 0
16 0 16 1 17 0 1 0 1 0 1 0 1 0 1 0 5 0 6 0 6 0 6 0 7 0 1 0 1 0 1 0 1 0 1 0 1 0 1 0 1 0 5 0 29 0 16 1 16 0 16 0 16 1 17 0 12 0 13 0 13 0 14 0 15 0 16 1 16 0 16 0 16 1 17 0 1 0 1 0 1 0 1 0 1 0 1 0 1 0 1 0 1 0 1 0 1 0 1 0 1 0 1 0 1 0 1 0 1 0 1 0 1 0 1 0 1 0 1 0 1 0 15 0 16 1 16 0
16 0 16 1 28 0 7 0 1 0 1 0 5 0 6 0 29 0 16 1 16 1 16 1 28 0 6 0 6 0 6 0 6 0 6 0 6 0 6 0 6 0 29 0 16 1 16 1 16 0 16 0 16 1 17 0 12 0 13 0 13 0 14 0 15 0 16 1 16 0 16 0 16 1 17 0 1 0 1 0 1 0 1 0 1 0 1 0 1 0 1 0 1 0 1 0 1 0 1 0 1 0 1 0 1 0 1 0 1 0 1 0 1 0 1 0 1 0 1 0 1 0 15 0 16 1 16 0
16 0 16 1 16 1 28 0 6 0 6 0 29 0 16 1 16 1 16 1 16 0 16 1 16 1 16 1 16 1 16 1 16 1 16 1 16 1 16 1 16 1 16 1 16 1 16 1 16 0 16 0 16 1 17 0 22 0 11 0 10 0 24 0 15 0 16 1 16 0 16 0 16 1 17 0 1 0 1 0 1 0 1 0 1 0 1 0 1 0 1 0 1 0 1 0 1 0 1 0 1 0 1 0 1 0 1 0 1 0 1 0 1 0 1 0 1 0 1 0 1 0 15 0 16 1 16 0
16 0 16 0 16 1 16 1 16 1 16 1 16 1 16 1 16 1 16 1 16 1 16 1 16 1 16 1 16 0 16 0 16 0 16 0 16 1 16 1 16 1 18 0 19 0 16 1 16 1 16 0 16 1 28 0 7 0 12 0 14 0 5 0 29 0 16 1 16 0 16 1 16 1 17 0 1 0 1 0 1 0 1 0 1 0 1 0 1 0 1 0 1 0 1 0 1 0 1 0 1 0 1 0 1 0 1 0 1 0 1 0 1 0 1 0 1 0 1 0 1 0 15 0 16 1 16 0
16 0 16 0 16 1 16 1 16 1 18 0 26 0 26 0 26 0 26 0 26 0 26 0 19 0 16 1 16 1 16 1 16 1 16 1 16 1 18 0 26 0 27 0 25 0 19 0 16 1 16 1 16 1 16 1 17 0 12 0 14 0 15 0 16 1 16 1 16 1 16 1 18 0 27 0 1 0 1 0 1 0 1 0 1 0 1 0 1 0 1 0 1 0 1 0 1 0 1 0 1 0 1 0 1 0 1 0 1 0 1 0 1 0 1 0 1 0 1 0 1 0 15 0 16 1 16 0
16 0 16 1 16 1 18 0 26 0 27 0 1 0 1 0 1 0 1 0 1 0 1 0 25 0 26 0 26 0 26 0 26 0 26 0 26 0 27 0 1 0 1 0 1 0 25 0 19 0 16 1 16 1 16 1 17 0 12 0 14 0 15 0 16 1 16 1 18 0 26 0 27 0 1 0 1 0 1 0 1 0 1 0 1 0 1 0 1 0 1 0 2 0 3 0 3 0 3 0 3 0 4 0 1 0 1 0 1 0 1 0 1 0 1 0 1 0 1 0 1 0 15 0 16 1 16 0
16 0 16 1 18 0 27 0 1 0 2 0 3 0 3 0 3 0 4 0 1 0 1 0 1 0 1 0 1 0 1 0 1 0 1 0 1 0 1 0 1 0 1 0 1 0 1 0 25 0 26 0 26 0 26 0 27 0 12 0 14 0 25 0 26 0 26 0 27 0 1 0 1 0 1 0 1 0 1 0 1 0 1 0 1 0 1 0 1 0 2 0 21 0 13 0 13 0 13 0 13 0 20 0 4 0 1 0 1 0 1 0 1 0 1 0 1 0 1 0 1 0 15 0 16 1 16 0
16 1 16 1 17 0 1 0 1 0 12 0 13 0 13 0 13 0 20 0 3 0 3 0 4 0 1 0 1 0 1 0 1 0 1 0 1 0 1 0 1 0 1 0 1 0 1 0 1 0 1 0 1 0 1 0 2 0 21 0 20 0 4 0 1 0 1 0 1 0 1 0 1 0 1 0 1 0 1 0 1 0 1 0 1 0 1 0 2 0 21 0 13 0 13 0 13 0 10 0 11 0 13 0 20 0 4 0 1 0 1 0 1 0 1 0 1 0 1 0 1 0 15 0 16 1 16 0
16 1 18 0 27 0 1 0 1 0 12 0 13 0 13 0 13 0 13 0 13 0 13 0 14 0 1 0 1 0 1 0 1 0 1 0 1 0 1 0 1 0 1 0 1 0 1 0 1 0 1 0 1 0 1 0 12 0 13 0 10 0 24 0 1 0 1 0 1 0 1 0 1 0 1 0 1 0 1 0 1 0 1 0 1 0 1 0 12 0 13 0 13 0 13 0 13 0 20 0 21 0 13 0 13 0 14 0 1 0 1 0 1 0 1 0 1 0 1 0 1 0 15 0 16 1 16 0
16 1 17 0 1 0 1 0 1 0 22 0 11 0 13 0 13 0 13 0 13 0 10 0 24 0 1 0 1 0 1 0 1 0 1 0 1 0 1 0 1 0 1 0 1 0 1 0 1 0 1 0 1 0 1 0 22 0 23 0 24 0 1 0 1 0 1 0 1 0 1 0 1 0 1 0 1 0 1 0 1 0 1 0 1 0 1 0 12 0 13 0 13 0 13 0 13 0 13 0 13 0 13 0 13 0 14 0 1 0 1 0 1 0 1 0 1 0 1 0 1 0 15 0 16 1 16 0
16 1 17 0 1 0 1 0 1 0 1 0 22 0 23 0 23 0 23 0 23 0 24 0 1 0 1 0 1 0 1 0 1 0 1 0 1 0 1 0 1 0 1 0 1 0 1 0 1 0 1 0 1 0 1 0 1 0 1 0 1 0 1 0 1 0 1 0 1 0 1 0 1 0 1 0 1 0 1 0 1 0 1 0 1 0 1 0 22 0 11 0 13 0 13 0 13 0 13 0 13 0 13 0 10 0 24 0 1 0 1 0 1 0 1 0 1 0 1 0 1 0 15 0 16 1 16 0
16 1 17 0 1 0 1 0 1 0 1 0 1 0 1 0 1 0 1 0 1 0 1 0 1 0 1 0 1 0 1 0 1 0 1 0 1 0 1 0 1 0 1 0 1 0 1 0 1 0 1 0 1 0 1 0 1 0 1 0 1 0 1 0 1 0 1 0 1 0 1 0 1 0 1 0 1 0 1 0 1 0 1 0 1 0 1 0 1 0 22 0 23 0 11 0 13 0 13 0 13 0 10 0 24 0 1 0 1 0 1 0 1 0 1 0 1 0 1 0 5 0 29 0 16 1 16 0
16 1 17 0 1 0 1 0 1 0 1 0 1 0 1 0 1 0 1 0 1 0 1 0 1 0 1 0 1 0 1 0 1 0 1 0 1 0 1 0 1 0 1 0 1 0 1 0 1 0 1 0 1 0 1 0 1 0 1 0 1 0 1 0 1 0 1 0 1 0 1 0 1 0 1 0 1 0 1 0 1 0 1 0 1 0 1 0 1 0 1 0 1 0 22 0 23 0 23 0 23 0 24 0 1 0 1 0 1 0 1 0 1 0 1 0 1 0 1 0 15 0 16 1 16 1 16 0
16 1 28 0 7 0 1 0 1 0 1 0 1 0 1 0 1 0 1 0 1 0 1 0 1 0 1 0 1 0 1 0 1 0 1 0 1 0 1 0 1 0 1 0 1 0 1 0 1 0 1 0 1 0 1 0 1 0 1 0 1 0 1 0 1 0 1 0 1 0 1 0 1 0 1 0 1 0 1 0 1 0 1 0 1 0 1 0 1 0 1 0 1 0 1 0 1 0 1 0 1 0 1 0 1 0 1 0 1 0 1 0 1 0 1 0 1 0 5 0 29 0 16 1 16 0 16 0
16 1 16 1 28 0 7 0 1 0 1 0 1 0 1 0 1 0 1 0 1 0 1 0 1 0 1 0 1 0 1 0 1 0 1 0 1 0 1 0 1 0 1 0 1 0 1 0 1 0 1 0 5 0 6 0 6 0 6 0 6 0 6 0 7 0 1 0 1 0 1 0 1 0 1 0 1 0 1 0 1 0 1 0 1 0 1 0 1 0 1 0 1 0 1 0 1 0 1 0 1 0 1 0 1 0 1 0 1 0 1 0 1 0 5 0 6 0 29 0 16 1 16 1 16 0 16 0
16 0 16 1 16 1 28 0 6 0 7 0 1 0 1 0 1 0 1 0 1 0 1 0 1 0 1 0 1 0 1 0 1 0 1 0 1 0 1 0 1 0 1 0 1 0 1 0 5 0 6 0 29 0 16 1 16 1 16 1 16 1 16 1 28 0 7 0 1 0 1 0 1 0 1 0 1 0 1 0 1 0 1 0 1 0 1 0 1 0 1 0 1 0 1 0 1 0 1 0 1 0 1 0 1 0 1 0 1 0 5 0 6 0 29 0 16 1 16 1 16 1 16 0 16 0 16 0
16 0 16 0 16 1 16 1 16 1 28 0 6 0 7 0 1 0 1 0 1 0 1 0 1 0 1 0 1 0 1 0 1 0 1 0 1 0 1 0 1 0 1 0 5 0 6 0 29 0 16 1 16 1 16 1 16 0 16 0 16 0 16 1 16 1 28 0 6 0 7 0 1 0 1 0 1 0 1 0 1 0 1 0 1 0 1 0 1 0 1 0 1 0 1 0 1 0 1 0 1 0 1 0 1 0 1 0 5 0 29 0 16 1 16 1 16 1 16 0 16 0 16 0 16 0 16 0
16 0 16 0 16 0 16 0 16 1 16 1 16 1 28 0 6 0 6 0 7 0 1 0 1 0 1 0 1 0 1 0 1 0 1 0 1 0 1 0 1 0 5 0 29 0 16 1 16 1 16 1 16 0 16 0 16 0 16 0 16 0 16 0 16 1 16 1 16 1 28 0 6 0 7 0 1 0 1 0 1 0 1 0 1 0 1 0 1 0 1 0 1 0 1 0 1 0 1 0 1 0 1 0 5 0 6 0 29 0 16 1 16 1 16 0 16 0 16 0 16 0 16 0 16 0 16 0
16 0 16 0 16 0 16 0 16 0 16 0 16 1 16 1 16 1 16 1 28 0 6 0 6 0 7 0 1 0 1 0 1 0 1 0 5 0 6 0 6 0 29 0 16 1 16 1 16 0 16 0 16 0 16 0 16 0 16 0 16 0 16 0 16 0 16 0 16 1 16 1 16 1 28 0 6 0 7 0 1 0 1 0 1 0 1 0 1 0 1 0 1 0 1 0 1 0 5 0 6 0 6 0 29 0 16 1 16 1 16 1 16 0 16 0 16 0 16 0 16 0 16 0 16 0 16 0
16 0 16 0 16 0 16 0 16 0 16 0 16 0 16 0 16 0 16 1 16 1 16 1 16 1 28 0 6 0 6 0 6 0 6 0 29 0 16 1 16 1 16 1 16 1 16 0 16 0 16 0 16 0 16 0 16 0 16 0 16 0 16 0 16 0 16 0 16 0 16 0 16 1 16 1 16 1 28 0 6 0 6 0 6 0 6 0 6 0 6 0 6 0 6 0 6 0 29 0 16 1 16 1 16 1 16 1 16 0 16 0 16 0 16 0 16 0 16 0 16 0 16 0 16 0 16 0
16 0 16 0 16 0 16 0 16 0 16 0 16 0 16 0 16 0 16 0 16 0 16 0 16 1 16 1 16 1 16 1 16 1 16 1 16 1 16 1 16 0 16 0 16 0 16 0 16 0 16 0 16 0 16 0 16 0 16 0 16 0 16 0 16 0 16 0 16 0 16 0 16 0 16 0 16 1 16 1 16 1 16 1 16 1 16 1 16 1 16 1 16 1 16 1 16 1 16 1 16 1 16 0 16 0 16 0 16 0 16 0 16 0 16 0 16 0 16 0 16 0 16 0 16 0 16 0
16 0 16 0 16 0 16 0 16 0 16 0 16 0 16 0 16 0 16 0 16 0 16 0 16 0 16 0 16 0 16 0 16 0 16 0 16 0 16 0 16 0 16 0 16 0 16 0 16 0 16 0 16 0 16 0 16 0 16 0 16 0 16 0 16 0 16 0 16 0 16 0 16 0 16 0 16 0 16 0 16 0 16 0 16 0 16 0 16 0 16 0 16 0 16 0 16 0 16 0 16 0 16 0 16 0 16 0 16 0 16 0 16 0 16 0 16 0 16 0 16 0 16 0 16 0 16 0
16 0 16 0 16 0 16 0 16 0 16 0 16 0 16 0 16 0 16 0 16 0 16 0 16 0 16 0 16 0 16 0 16 0 16 0 16 0 16 0 16 0 16 0 16 0 16 0 16 0 16 0 16 0 16 0 16 0 16 0 16 0 16 0 16 0 16 0 16 0 16 0 16 0 16 0 16 0 16 0 16 0 16 0 16 0 16 0 16 0 16 0 16 0 16 0 16 0 16 0 16 0 16 0 16 0 16 0 16 0 16 0 16 0 16 0 16 0 16 0 16 0 16 0 16 0 16 0